12 8
2 2 3 3 3 3 2 2
1 2 2 2 2 2 2 1
3 3 3 3 3 3 3 3
2 2 2 2 2 2 2 2
1 1 4 1 1 4 1 1
1 1 1 1 1 1 1 1
0 0 0 0 0 0 0 0
0 0 0 0 0 0 0 0
0 0 0 0 0 0 0 0
0 0 0 0 0 0 0 0
0 0 0 0 0 0 0 0
0 0 0 0 0 0 0 0